111111111
1CCCCP001
1CCCCCCC1
1CCCCCEC1
111111111