1111111111111
1C110C0C000C1
10X0011111001
1P0011E000001
1111111111111