11111111111111111111111111111
100000C00000000000000000000E1
10000000000000000000000000001
100000P0000000000000000000001
10000000000000000000000000001
11111111111111111111111111111