11111111111111111111111111111
100000C1000000000000000000001
10E00001000000000000000000001
100000P1000000000000000000001
10000001000000000000000000001
11111111111111111111111111111